R  1024 768

NO ./path_ to_the_north_texture

SOd ./path_to_the_south_texture

WE ./path_to_the_west_texture

EA ./path_to_the_east_texture

S ./path_to_the_sprite_texture

F 122,4,235

C 254,117,254

        1111111111111111111 11111
        1N00000000110000001 10001
        1011000001110000001 10001
        1001000000000000001 10001
111111111011000001110000001110001
100000000011000001110111111111111
11110111111111011100000010001
11110111111111011101010010001
11000000110101011100000010001
10002000000000001100000010001
10000000000000001101010010001
110000011101010111110111100111
11110111 1110101 101111010001
11111111 1111111 111111111111
 11
 1