R     1200            800

F      112,     25,    167

C       25,     235, 156

NO  ./textures/bluestone.xpm

SO  ./textures/colorstone.xpm

WE  ./textures/greystone.xpm

EA  ./textures/mossy.xpm

S  ./textures/barrel.xpm

        1111111111111111111 11111
        1110000000110000001 10001
          11000001110000001 10001
        1111000000000000001 10001
111111111011000001110000001110001
100020000011000001110111111111111
11110111111111011100000010001
11110111111111011101010010001
 1111111111111111111111110001
11E02000000000000000000000001
10000000000000000000000010001
110101011101010110110111100111
11110111 1110101 101111010001
11111111 1111111 111111111111
 11
 1