R     1024            768


F     235 ,    235       ,         0             




C        235 ,    235       ,         0     

NO              ./textures/bluestone.xpm



SO           ./textures/colorstone.xpm

WE  ./textures/greystone.xpm

EA  ./textures/mossy.xpm

S  ./textures/barrel.xpm

        1111111111111111111 11111
        1110000000110000001 10001
          11000001110000001 10001
        1111000000000000001 10001
111111111011000001110000001110001
1E0020000011000001110111111111111
11110111111111011100000010001
11110111111111011101010010001
 1000000110101011100000010001
11002000000000001100000010001
10000000000000001101010010001
110000011101010111110111100111
11110111 1110101 101111010001
11111111 1111111 111111111111
 11
 1