R  1280 768

F 122,4,235hjj




C 235,235,0

S ./textures/barrel.xpm

NO ./textures/bluestone.xpm

SO ./textures/colorstone.xpm

WE ./textures/greystone.xpm

EA ./textures/mossy.xpm



1111111
12002S1
1002001
1020001
1200001
1111111