R  1500 800

S ./textures/barrel.xpm

NO ./textures/bluestone.xpm

SO ./textures/colorstone.xpm

WE ./textures/greystone.xpm

EA ./textures/mossy.xpm



F 122,4,235

C 254,117,254

1111111
10000N1
1002001
1020001
1200001
1111111
