R 641 900
NO ./pics/blue.xpm
SO ./pics/brick.xpm
WE ./pics/wood.xpm
EA ./pics/grey.xpm
S ./pics/pillar.xpm
F 220,100,0
C 225,30,0

        1111111111111111111111111
        1000000000110000000000001
        1011000001110202020202021
        1001000000000000000000001
111111111011000001110000000000001
120000000011000001110111110111111
11110111111111011100000010001
11110111111111011101010010001
11000000110101011100000010001
12000000000000001100000010N01
12000000000000001101010010001
1100000111010101111101111000111
11110111 1110101 101111010001
11111111 1111111 111111111111
 
 
111
101
111